.............................
.............................
.............................
.......#......#..............
..........##..............#..
............##............##.
..............#..........#...
.....................#...##..
........#....#.....###.......
.......#......#..##..........
..#...........#...##.........
.........#...................
.........#..#................
....##.............#.........
................#.##.##......
.............#..#.....#......
...........##..#.##..#.......
...............#...#...#.....
..#.....##.....#..#.#........
.............................
........#............#.......
...##........................
.......##.......#.......#....
.......#......#..............
.......#.......#.............
...........#.................
...........##...#............
..........#...#..#.........#.
.............................
