###################.##.#.....
################....#.#..#..#
###############.#.#.#..##.##.
###############.#.#.#...#.###
###############.#...#.#..#...
#################..##.##.....
##############...#.##..#.##..
#############.#.##...###...#.
##########....#.#.##.####..#.
###########...#.#..###..##.##
###############..#.#.##.##.#.
###############..##..#..###.#
######...######.#######.....#
######..#######.#.####...###.
#######.####.....#####..#####
###...#.####....#..###..#####
###.###.##.....#.#.##...#####
...#.#.##.#.#....#...#...#...
.###...#.#####.#.#.##.#####..
.#.###.#..#.###..##.##.###.#.
.#.#########.#.##.#....#.##.#
#.##..###.##..###...#...##...
.#...#...#.#####.##.#.#...#..
.###.......#.####.##..#.#...#
####.#..#.......#..###.#.....
..###.##...###....##.#####.#.
#...#.....#..#....##....##.#.
#...#.#.#......##.###..#....#
##......#..#.#.##....##..#...
