...#.................#...#...
##.#####.#.###.###.###.###.##
.......#.#.#...#.....#.#.....
.###.#######.#########.#####.
.#.#.........#.....#.........
.#.#.###.#.#.###.###.########
...#.#.#.#.#...#.#.#.........
####.#.###.#.#.#.#.###.#####.
.........#.#.#.......#.#.....
####.#####.###########.#.###.
...#.#...#...........#.#...#.
.#.###.#.###.#########.###.##
.#.#.#.#.#.....#.#.....#.#...
##.#.#.###.#.#.#.#.###.#.####
.#...#.....#.#...#.#.......#.
.###.###.#.#####.#.#####.###.
.#.......#.#...#.......#.....
.###.###.#####.#######.#.#.##
.....#.#...#.....#.#...#.#.#.
.#.###.#.###.#.#.#.#.###.#.#.
.#...#.....#.#.#.#.#...#.#.#.
.#.#####.#.#####.#.#.###.###.
.#.#.....#.#...#...#...#.....
.#####.###.#.###.#########.##
.#...#...#.#.#...#...........
####.#.#####.#.#######.###.##
.........#.......#.#.....#...
.#.#.###.#.#####.#.#.#.######
.#.#...#.......#.#...#.......
