.......#.....#...#.....#.#.#.#.....#....#.#.##...
.#.#########.#.#.###.###.#.#.#.#####.#....#.#....
.#.......#...#.#.#.......#...................#...
##.###.###.###.#########.#######.####............
...#...............#...#...#...#...#......#.#....
.#####.#.###########.#.#.#.###.#.###....#........
...#.#.#.#...#.#...#.#...#.#..............#...#..
.###.#.###.###.#.#####.#####.#.###.##..#..#......
.....#.#.#.......#.#.#.#.....#...#...#......#....
######.#.#######.#.#.#.###.#.#####.#.............
...........#.#...#.......#.#...#.#.#.........#...
.#.#.#####.#.#.#####.###.#.#####.###...#.........
.#.#.#.#.....#.#.....#.#.#...#...........#.......
.###.#.#.###.#.###.#.#.#####.########...#........
...#.#...#.......#.#.........#...#....##...##....
##.###.###.#.#####.#.#######.#.###.#.#...#.....#.
.....#...#.#...#.#.#.#.......#.....#....#.#......
##.#####.###.###.#.###.#.#.#.#.#.#.###....#..##..
.......#.#.....#...#...#.#.#...#.#...............
##.#.#####.#######.#.###.#.#####.#.##.#..#.......
...#.#.#.#.........#...#.#...#...#.#..#..........
##.#.#.#.#.#####.###.###.#.#.#####.#..........#..
...#.#.#...#.#...#.#.#...#.#...#.#....#..........
######.#.###.#.###.#.#.#####.###.###.#...........
.............#...##..###....#.##...####.#.##....#
............#.......#.#......#..##..#..#..#...#.#
.#.........#......###..######..##.###...##..#....
.........#....#...#.###...###..##......#.####..#.
....#......#.....##.##.#......##....###...#.#..##
.#.....#..............##....#..##.#####.###...##.
..#...............#.#.#.###..##.##########.###...
#...........#.#.....#.##...#.####.###.#..####..##
.............#....########..####......##.##.#...#
.#....#..##.......#.####.#...#.##.##.#..#.##...##
.............#.....#.#..#.###.#######.#.#...##...
.#..#......#..#..#.#.#..##.......########.#.#...#
......#.....#......##..#.####.#...##....##....##.
.....#.#.##.....#.###.##...##.####...#.....##.#.#
...........#..##.####.#..#..#...##.##..#.#....##.
.....#..#......#..#####..#..###.###..#...#.##.###
#.#.#........#.#..######.##.#.##..########.##..#.
............#...........#....###.......#.#.#.#.#.
..................###..#..#.#..#........#.#.#...#
..........#........#.#.####.#.###.###########..#.
#.#...#..#...#.........####............#####.##..
.##..............###.#..##..#..#..##.#.#####.##.#
...................#..#...#...#..#.###.#####.####
#.............#......###.####.....#.#.#.#########
.#......#..........#....####...#..#.##.##########
