........#.................#..
.#...................#....#..
..........#..#.#............#
.................#....###.#..
.#..................#..#..#..
...##.............#....#.....
..#..#...........#...........
....................#......#.
............#....#..##.......
#....#....................#..
......##..#..#......###...#..
..#.#.#.#.#.............#....
.#...#.....................#.
...#..#####...........##.....
....................#.......#
...##.#.............#.......#
.#....#...............#......
...#...##..............#.....
.......#.#...........#.......
.....#...#............#.#....
.##..###..#....#...#.#.#.##..
#..#.#..##....#......#.##.#..
..###...#.#......#...#..#.###
.......##..##.#.#....#..#.##.
....#..#.##.#..#.#.#.#.#.##..
..#..#....#.......#....##.##.
#............###....#.##...##
...#...#..##..#.........##...
..#.......#..##.....#..#..#..
